10 16
GGGRRGRRGGRGGGRG
GGGGRGRGGRRRGGGR
GGGGGGGGGGRGGGGG
RGGGGGGGGGGGGGGG
RRGGGRGGGGGGGGGR
RGGGRRRGGGGGGGRG
RRGGGRRRGGGGGGGG
RRRGGGRGGGRGGGGR
RRGGGGGGGRRRGGRR
RGGGGRGGRRRRRRRR