6 14
GGGGGGGGGRGGGG
GGGGGGGGGRGGGG
GGGGGGGGGRGGGG
GGRGGGGGGGGGGG
GGGGGGGGGGGGGG
GGRGGGGGGRGGGG