5 10
GRGGRRRRRR
GGGRRGGRGG
GRRRRGGRRR
GGGGGGGRRR
GGGGRRRRRR