5 10
GRGGRRRRRR
GGGRRGGGGG
GRRRRGGRRR
GGGGGGGRRR
GGGGRRRRRR